1111111111
1P0C000001
10C0C10011
1C0E00C011
1111111111
