1111111111
1P0C000001
10000C00C1
1C0E000C01
1111111111
